aduc=aduci
aduci=aduc
ai=am
am=ai
avem=aveti
ascult=asculti
asculti=ascult
beau=bei
bei=beau
cad=cazi
cant=canti
canti=cant
cazi=cad
citesc=citesti
citesti=citesc
conduc=conduci
conduci=conduc
cred=crezi
crezi=cred
cumpar=cumperi
cumperi=cumpar
dorm=dormi
dormi=dorm
esti=sunt
fac=faci
facem=faceti
faci=fac
fiu=fii
fii=fiu
gandesc=gandesti
gandesti=gandesc
iau=iei
iei=iau
ies=iesi
iesi=ies
intri=intru
intru=intri
invat=inveti
inveti=invat
iubesc=iubesti
iubesti=iubesc
mananc=mananci
mananci=mananc
merg=mergi
mergem=mergeti
mergi=merg
mint=minti
minti=mint
mor=mori
mori=mor
muncesc=muncesti
muncesti=muncesc
plec=pleci
pleci=plec
pot=poti
poti=pot
putem=puteti
scrii=scriu
scriu=scrii
simt=simti
simti=simt
spui=spun
spun=spui
stii=stiu
stiu=stii
sufar=suferi
suferi=sufar
sunt=esti
suntem=stunteti
testez=testezi
testezi=testezi
traiesc=traiesti
traiesti=traiesc
trec=treci
treci=trec
trezesc=trezesti
trezesti=trezesc
uit=uiti
uiti=uit
urasc=urasti
urasti=urasc
vii=vin
vin=vii
vorbesc=vorbesti
vorbesti=vorbesc
vreau=vrei
vrei=vreau
zic=zici
zici=zic
ma=te
te=ma
mine=tine
tine=mine
eu=tu
tu=eu
tale=mele
mele=tale
imi=iti
iti=imi
mi=ti
ti=mi
mea=ta
ta=mea
meu=tau
tau=meu
m=te
